111111111111111
10P00000C0001C1
100001000110101
10C0010C01EC101
1000C0000111101
10000000M000001
100000C00000001
1111111000C0001
1000C0111011111
100000C00C000C1
111111111111111