111111111111111111111111111111
10P00000C0001C0000000111001001
100001000110101000000111001C01
10C0010C01EC101000000000000001
1000C0000111101000011111100001
1000000000000010000100C0100001
100000C000000000M0001000100001
1111111000C00010C0000011100001
1000C01110111110000C0111001001
100000C00C000C10000000C0000001
111111111111111111111111111111