1111111111111
10P0C000C1C01
1000010M01011
10C0010C01E11
1000C10000C01
1111111111111